NO assets/rock.xpm
SO assets/window.xpm
WE assets/brick.xpm
EA assets/wood.xpm


F 100,000,000
C 000,000,200


11111111111111111111111111111111111111111111
10000000001000001000000000000000000000000011
10000000001001101000000000000000000000000011
10000000001000000000000000010000000000000011
10000000001000000000000000000000000000000011
11000000000000000N00000000000000000000000001
1100000000100000000000000000000000000000001
11000000000000000000000000000000000000000001
11000000000000000000000001000000000000000001
1000000000000000000000000000000000000000001
1111111111111111111111111111111111111111111

