NO NON
SO FUNZIONA
WE COSI
EA CUB3D


F 100,000,000
C 000,000,200


111111111111111111111
100000000000000000001
10000000N000000000001
100000000000000000001
111111111111111111111
