NO assets/rock.xpm
SO assets/window.xpm
WE assets/brick.xpm
EA assets/wood.xpm


F 100,000,000
C 000,000,200


111111111111111111111
100000000000000000000
100000000000000000000
100000000000000000000
111111111111111111111
